11111111111111111111111111111111111111111111111111
1000C000000000000000000000000000000000000000000001
1011100000000000000000000000000000C000000000000001
100E1000000000000000000000000000000000000000000001
11111111111111111111111111111111111111111111000001
1000000000001000000000C00000010000000000C1C0000001
10000C00000010000000000000000000000000000100000001
10000000000000000000000000000100000000000100000001
11111111111111101111111111111110000000000100000001
10000000000000001000000000000010000000000100000001
100C0000000000001000000000000010000000000000000001
1000000000000000100000CC00000010000111111100000001
1000000000000000100000CC00000010000000000100000001
1000000000000C001000000000000010000000000100000001
1000C000000000001000000000000010000000000100000001
100111111111111110000000000000100000000001CCCCCCC1
10000000000000001001111111111111111111111111111111
10000000000100001000000000010000000000000100000001
1000000000010C00100000000001000000000000C000000001
1C00000000010000100000000000C000000000000100000001
111111111111CC001111111111111111111111111111110111
10000000000000CC000000000000000000000000C000000001
10000000000000000000000000000000000000000000000001
11111111111111111111111111111111111111111111101111
1CCCP10000000000000000000001C000000000010000000001
1C00C100000000000001000000010000000000010000000001
1C00C1000000000C0001000000010000000000010000000001
1C00C100000000000001000000010000000000010000000001
1C00C1000000C0000001000000010000000000010000000001
1CCCC100000000000001000000000000000000010000000001
10000100000000000001000000010000000000010000000001
10000C00000000000001000000010000000000C100000000C1
1CCCC111111111111111111111110111111111110111111111
1000000000000000000000000000000000C100000000000001
10000000000000001000000000000000000100000000000001
1000000000000000100000000000000C00010C000000000001
1000000C000000001000000000000000000100000000000001
10000000000000001000000000000000000100000000000001
11111111111011111111111110111111111111111111111101
1000000000000000100001000000000100000C000000000001
10000000000000001000010000000001000000000000000001
10000000000000000000010000000001000000000000000001
1000000C000000001000010000000001000000000000000001
10000000000000001000010000000001000000000000000001
11111111111111111011111111111111111101111111111111
10000000000000001000000000000000000000000000000001
1000000000000000100000000C000001000000000000000001
1000000C000000001000000000000001000000000000000001
1000000000000000000000000000000100C000000000000001
11111111111111111111111111111111111111111111111111
