11111111
10C000E1
10001C01
1000P101
1C1000C1
11111111