1111111111111111111
1E00000000000000001
1000000000000000001
1000000000000000001
100CCC0000000CCC001
1000100000000010001
1000000000000000001
1000000000000000001
10000000CC000000001
10000000CC000000001
1001000000000001001
1001000000000001001
1000100000000010001
1000010000000100001
1000001111111000001
1000000C00C00000001
1000000C00C00000001
1000000000000000001
10000000000000000P1
1111111111111111111
