01111111
100E0001
10000001
10C000P0
11111111
