111111111
1C0000001
1000000P1
111111111
