111111111
1E0000001
1000000C1
111111111
