111111111
1E00001
100001
10000P1
11111111
