11111
1E0C1
11101
1C101
111C1
1P001
11111
