1111111
10C00P1
1110C01
1E10001
1111111
